R 1920 1080 
NO ./textures/grey.xpm
SO ./textures/colorstone.png
WE ./textures/brick.xpm
EA ./textures/eagle.png
S ./textures/barrel.png
F 100,100,20
C 100,150,100

1111111111111111111111111111111111111111
1000000000000000000000000000000000000001
1100000000000000000000000000010000000001
1000000000000000000000000000000000000001
1000000000000000000000000000000000000001
1000000000000000000000000000000000000001
1010000000000000000000000000000000100001
1000000000000000000000000000000000000001
1000000000000000000000000000000000000001
1000000001000000000000001000000001000001
1000000000000000001000001000000001000001
1000000000000000000000010000000000000001
1000000000000100000000000000000001000001
1000000000000000000000100001000000000001
1000000000000000000000000100000000000001
1000000000000000000000000010000000001001
1000000000000000000000000000000001000001
1000000000000000000000000000100000000001
1000000000000100001000000000000000000001
1000000000001000000000000000100000000001
1000000000000100000000100000000000000001
1000000000000000000000000000000000100001
1000001000000000001000000001000000000001
1000001001000000000200000000100000000001
1000000000000000000010000110000000100001
10N0000000000000000000000000000000000001
1000000000000000010000000000000000000001
1001000000000010000000000000000000000001
1000000000000000010000000000000000000001
1000000000000000000000000001010000000001
1000000000000000000000000000000000000001
1100000000010000000000000000000000000001
1000000000000000000000000000000002000001
1000000000000000000000000000000000000001
1100000000000000000000020000000000000001
1000001000000000000000000000010000000001
1000000000100000000000000000000000000001
1000000100000000000000000000000000000001
1100000000000000000000000000010000000001
1111111111111111111111111111111111111111
