R 1920 1080 
NO ./textures/grey.xpm
SO ./textures/colorstone.png
WE ./textures/brick.xpm
EA ./textures/eagle.png
S ./textures/barrel.png
F 100,100,20
C 100,150,100

1111111111111111111111111111111111111111111111111111111111111111111111111111111111111111111111111111
1100110110101101111000001111110101101100101000012020101100101001101101001110010000010120112001011001
1100101111101011101111001011110000101111011001111100100100010101100110100101101011201011101100011111
1111010110011000110000112100101100000000001000011120100110100110110010010001101001000000010002010011
1011101101001100011101110001110101100000001110110100001101010111001001011101011011100101100111001011
1100110111001110101110000120211111100001110010010100110011110112110010011220100000000001121011001101
1111011100100001111011101001100100110211100101000101001110110100001101010100000111110011011010010111
1111021010111000110010111111101111001000100210100000000110111120111101000110101111101001112000010101
1020000010101010010101202001101112110101010110001001000010101010000001010020111110000101011001101011
1001010100011001000101100101011111011100000100010001100101111110101011111101110111010000100000001101
1111010000001000020010001101111010101112011111101111110110010012010011011011200001000011110111000001
1000000000121110010001011110110001011010110101101011101100001110101111001010100111100110001111100001
1111001001011111001100110011110010110001101001100111011100001011011011010111011101100010001100001011
1000001100020001000111000100001000001110011000111110111110000111000110101010011001110211000111111101
1002111000111210111001111121111001210100112011000000000101110010111010110001210100110000100010110111
1000100011011000000002100001010020110110000001012100101111000111011101011011111101011100011100000101
1100101100101011000110111110111000000010110211001120111101111001010012111100000100112111010000121001
1100010010102010101001111101011010001000000001100100110101000201110111010001110001101111011002110011
1000110001011000002101111111100001120110000000200011002011000010100010101000101001000011110101100101
1110000100001110110001001100010020210000100010001110101000011011100100101111010010100120111011001001
1110110000000110110000001011010100011101000102000010000011011100110101000111011011111101101110111001
1011111111101010000020111001111011211111102010021020011110111011000101110000100011111110S10011100111
1100000100002000101000111001101111000001110101011011100100011011100121111101000110101101110101011101
1111011110101000001100110111111010001110000000101000101000011011010001010001100010101010000101100101
1100111001111100012010101000010011020001001100101000111011000120011111011110210010010110111010101001
1111000100110000101120011010200010000110010100011010011110000200110011201100001110001111100011101101
1110011011011101110001101110000111011001011000101010011001100001101110010010011101010101101110110111
1000000000110101011011100110001100011000001011010000100001110010011110000110100000011011010100010121
1001011010101000001000010021110000011111100001001110000000010011100110100000110010001010110010010111
1011000001021001000110011211011101101111001101011101001001111011021101011011000010001011100011110011
1101111100101001110101101011000011110100100110110101110001110020111100001011011101101111000111001011
1110110010000101010001100110010111100000101000012000100111110101101111001001000100110100000010011111
1111011100010100001111101100101211110100011000020020010111100020011101111010011111000111100111011011
1101111011110010000010100000200101001101000100200101001110110110110101110101100000010010111011011011
1000210101000000111010001110001111011101101011100001101000101101100000010000021001011011010100010101
1111010100001100111100011010110110000011110210201011011001100120110001111110010001000011110010101101
1010111110100101111002001121101001101000101001100100010100011010000011010010011111010111010000110001
1000010100100011110001100001110101111010110100100111110111000010012111001011010000101010010101011101
1101101101000010010001111000010010011001011010110001010010010011001100101011111111011011110120201001
1101000101101101100000101000111100111011111112111010011111011111000000000111010000010011000111000111
1001120100001000011002101000101101000011111000001011001101100010111011111011101001010100100110101111
1011011101100111110101100010001101001100000011000101001112011111000011001001100100101011100101011111
1111000110110000011010110100020101011101000011100011100000010110000001000000011001111000012001110101
1100110101100010101100110101100100000111010001001101000210110111010000011011100101101010111010100001
1110111000100011011010000010100011010110000101100010101010110110000010111001100100101011100021100111
1100110111000000010100110100100011110100011111011010110001011111011111111000002010010001110001101111
1000011110110110102020100101000100101001000201011021001210110101100111011000002110111110011000110101
1010000010111010001010000111110010010000210011011100011011000010101001100011001101010111001011001011
1001101110100101100000110011101001010100100000011001001000211011010011000111001101111000010001001001
1010101001100101110000110111011000000200010010110111100011110001010110101010101011000001011001101111
1110110100111102010101101001001110110210100010010110100011000011101010010010110110110011100001010011
1010110001010011110011111111001001101002200000010010010110100010100010101001001010120001100011100101
1000120021111100000011111110011010001000011100100011001001111101101010001000110110010101110101000001
1000100111111020111010121110100010011011101100010110111101111000001010010000110020100000110111101001
1211000010011110101010000011101011001111110001000101011101000111111000101111100111110000011111011111
1102110110111111100111200011101010000011101111100101110010111010001001111001111011001101010010101111
1000010100000101111111001001001010011100111110001101011111110111011000101001001002011000101110110011
1110111111011110101000010111011010010001021001100000000111110001101010000100010111101101011110011101
1010110011001101110110100110000010101010000100000100111001000001100010111111101100111110100011100011
1001100020001000001120101101111001010100010110001011001010010010100011001011111110011111000010001101
1011111011100000210001011010011000101101100110210110100001000010011011012111010000011011111111001101
1010100000000100010000111110111001101000010100110101000001101110000210101011110010010200111010010111
1110100011101010011100011100000110110011120011110100021011111011010000100000001111012011110000100111
1110101011000111111100010111001110111100110101120001000001001101010011010001011000011111111101000121
1000101011101121010111010012110110200000110000111110001001000101000000111011000011011000010010110111
1001010101011010210110100110200011010111101110010010001000010001001011100111201000012002001110100011
1100101101111000011111010001110000101000100011100101111010000011100001011001210011100110110001010101
1010011100110101001100001111111110101101000111002101000100011001101111000001001011102100101111000101
1011110111121001110101011002111001001010101100000001010010000111100001100110010211101101001100121101
1111100110010010100001010100101100111001010001000000101000101101011000001101111000001000000102101111
1110001001111000011002000110011111100100011111011210101001111110011100110100100010000100110201100001
1000001100100001000200000100000011101010011000101100012000101111001101110100100010010101111011111101
1011111100101010001000100112110010001000000000111111211001100000000110120001100110000121110011110001
1100100001110001000010111100001121011100001000101011111100010111111011001001010110011100111101110001
1000010111110000100011101011101101011101100000000100010100010000001101000010020000000101100111101111
1001110001101011100001111111111110100010112101100101010001111000100111010100101110001011010010010111
1001100010100100001110011011111010010210000001000100011100111101011001011010101010001002100100100011
1101110102000000100000011101100001001021000012000111101010100110011100001100000110011010001001110101
1101000100001111011111001101101011021101100000111111011001001100001100010100001001101101001000100001
1011101001100101001011110001111002110110110001011110000010000001000110111110101110101001110010100101
1011001100101110010100011000001011021001011110101100010011001011110010001001000000111100111011111111
1000001101101111020110011200111111011011100000111010011001010001010100001110100100010200101010010111
1100000000102011012001010110111101001200000010011210110100001011011000000010000001011110100001100011
1011110001001111000211000010012111010000100100100111011001111001100110010011010001011000100011210101
1011010100110100111101001000000101000011010102110020111111111012110000120000111011001011101010100111
1010111010011001011100111020110011101011000110110011101111000011010100110010011101010010110010000111
1000110101101111100111001002000101000110111101010111001100022000001001112001001100000111110000111011
1101010020111000110100111111000010011001010011110201101010000011001110110101000011011100000001000011
1210010001000111110111011101011010010100011112000000101011100100010001100011101100100010100010110111
1011101010210010100111011111100112000000011001110111111101100111110000100200000011111111111110001001
1001001010001010010101000011011111010000010111101100110000011001000110010110011111001211010000101111
1010010000000000100110011110010020110111000001000111100110000101100011101101011111011001101101012001
1100011010010000011121100111001000100011210101101000101020000000000001001001000010101011100000111101
1011100011011101100011000100111000001000010110011011011110100202000001111010110100111010000101111101
1000011000000101002100021000101010000001100000100001111001000100111010011012011111000110000111001111
1110001110101110102101101011011100201010101000001011001201200101000002100010011011010110000100010011
1110011010100101110010111111000111111000000100100101110000002010111000001101100100001000110010101011
1000102111100100111100111101001002111010010010111001111011000010111000011000111110001111110100001111
1101100001001011001000111010100110101121001110101010101111102101011110111101000011100011100101100011
1111111111111111111111111111111111111111111111111111111111111111111111111111111111111111111111111111
