R 1920 1080 
NO ./textures/grey.xpm
SO ./textures/colorstone.png
WE ./textures/brick.xpm
EA ./textures/eagle.png
S ./textures/barrel.png
F 100,10,20
C 32,150,100

1111111111
1000000021
1000000001
1002000W01
1000000001
1000000001
1000000001
1000001001
1001000001
1111111111
